14 7 0 3 13 3
W W W W S W W W W W W W W W
W W W W G G G G G G S W I I
W W W W G W W W W G W W W W
G S G G G S W W W G W W G M
G W W W G W W W W G G G G W
G W W G G G G G G G W W W W
G G G G W W W W W W W W W W

