10 10 64
G G G G G G G I I I
G G G G G G W W W W
S G G G G G G G S S
G G G G G G G G G G
G G G G G G G G G G
G G G G G G G G G G
G G G G G G G G G G
G G G G G G G G G G
G G G G G G G G G G
G G G G G G G G G G